Vacant=Boş,açık
Vacation=Tatil
Vacuum cleaner=Elektrik süpürgesi
Vain=Gereksiz,boşuna
Valley=Vadi
Valuable=Değerli
Value=Değer
Van=Minibüs
Vanilla=Vanilya
Vaporize=Buharlaşmak
Variety=Fark,çeşitlilik,çeşit
Various=Değişik,çeşitli
Vase=Vazo
Vegetable=Sebze
Vehicle=Taşıt arası
Veil=Duvak
Vein=Damar
Velvet=Kadife
Venture=Macera,risk
Verb=Fiil
Verdict=Hüküm
Vertical=Dikey
Very=Çok,tam
Vest=atlet,fanila
Vet=Veteriner
Veto=Veto,veto etmek,reddetmek
Via=Geçerek,oradan
Viable=Geçerli
Vice=Yardımcı,liderin yardımcısı,mengene
Vicious circle=Kısır döngü
Victim=Kurban,kazazede
Victimize=Kurban etmek
Victor=Galip
Victory=Utku,zafer,yengi
View=Görünüm,manzara
Villa=Villa
Village=Köy
Vine=Bağ
Vinegar=Sirke
Violent=Kaba kuvvet kullanan,şiddet
Violin=Keman
Visa=Vize
Visible=Görünen
Vision=Görüş,imge
Visit=Ziyaret etmek
Visitor=Ziyaretçi,konuk
Vital=Çok önemli
Vocabulary=Kelime,dağarcığı
Voice=Ses
Volcano=Volkan,yanardağ
Volleyball=Valeybol
Volume=Hacim
Voluntary=Gönüllü
Vomit=Kusmak
Vote=Oy vermek,oy
Vowel=Sesli harf
Voyage=Deniz yolculuğu
Vulgar=Kaba,ilkel
Vulnerable=Zayıf,korumasız
Vulture=Akraba,haris kimse
