Wage=Saat ücreti
Wager=İddiaya girmek
Wagon=Vagon,yük vagonu,at arabası
Waist=Bel
Waistcoat=Yelek
Wait=Beklemek
Waiter=Garson
Wake=Uyanmak,uyandırmak
Walk=Yürümek,yürüyüş
Wall=Duvar
Wallet=Cüzdan
Walnut=Ceviz
Wander=Dolaşmak
Want=İstemek,istek
War=Savaş
Warder=Bekçi,muhafız,gardiyan
Wardrobe=Gardrop,büyük dolap
Ware=Eşya
Warehouse=Depo
Warm=Ilık,ılındırmak,sevecen
Warn=Uyarmak
Warrant=Garanti
Wash=Yıkamak,kirli çamaşır
Wasp=Arı
Waste=Artık,gereksinim duyulmayan,boşa harcamak
Watch=İzlemek,seyretmek,bakmak
Water=Su
Water proof=Su geçirmeyen
Waterfall=Şalale
Wave=Dalga,dalgalanma,el sallamak
Way=Yol,rota,yön
We=Biz
Weak=Zayıf,erksiz
Wealth=Servet
Weapon=Silah
Wear=Giymek
Weather=Hava,iklim
Wednesday=Çarşamba
Week=Hafta
Weigh=Ağırlık,tartmak
Welcome=Hoşgeldin,hoş geldin,ağırlamak
Well=İyi,kuyu
Well-known=Ünlü,bilinen
West=Batı
Wet=Nemli
Whale=Balina
What=Ne
Wheel=Ne zaman
Whenever=Herhangi bir zaman,ne zaman ki
Where=Nerede,nereye
While=Bu arada
Whip=Kırbaç
Whisper=Fısıldamak,fısıldaşmak
Whistle=Islık,ıslık çalmak,düdük
White=Beyaz,ak,beyaz tenli
Who=Kim
Whoever=Herkimse,her kimse
Whole=Tüm,bütün
Whose=Kimin
Why=Neden,niçin
Wide=Geniş,kenardan kenara
Widow=Dul
Wife=Karı,eş
Wig=Peruk
Wild=Vahşi
Will=İrade,istek,vasiyet
Win=Kazanmak,zafer
Wind=Rüzgar,sarmak,kurmak
Window=Pencere
Wine=Şarap
Wing=Kanat
Winter=Kış
Wipe=Silmek,kurulamak
Wire=Tel,telgraf
Wireless=Telsiz
Wisdom=Akıl
Wise=Zeki,akıllı
Wish=İstek,istemek
Witch=Cadı
With=İle
Withdraw=Çekmek,geri çekilmek,sızmak
Within=İçinde
Witness=Tanık,tanıklık etmek
Wolf=Kurt
Woman=Kadın
Wonder=Merak,merak etmek,şaşırmak
Wonderful=Şaşırtıcı,harika
Wood=Odun
Wool=Yün
Word=Sözcük,kelime
Work=İş,çalışmak
Worker=İşçi
World=Dünya
Worm=Solucan
Worry=Endişelenmek
Wound=Yaralamak,yara
Wrap=Sarmak,paketlemek
Wreck=Hurda,enkaz,çarpışma
Wrist=Bilek
Write=Yazmak
Wrong=Yanlış
