Fable=Masal,efsane
Fabulous=Harila,inanılmaz
Face=Yüz,surat,karşısına çıkmak
Fact=Gerçek
Factory=Fabrika
Fade=Solmak
Fail=Başarısız olmak
Failure=Başarısızlık,arıza,yetersizlik
Faint=Solgun,zayıf,bayılmak
Fair=Dürüst,adil,oldukça iyi
Fairly=Dürüstçe,epeyce
Faith=İnanç,güvenmek
Faithful=Güvenilir,sadık
Fake=Sahte,taklit
Fall=Düşmek,sonbahar
Fame=Şöhret,ün
Familiar=Tanıdık,bildik
Family=Aile,familya
Famous=Ünlü
Fan=Taraftar,hava hareketi
Fanatic=Fanatik
Fancy=Hayal kurma,hoş zevkli,fantazi
Fantastic=Harika,olağandışı
Far=Uzak
Fare=Ücret
Farm=Çiftlik
Farther=Daha uzak
Fashion=Moda
Fast=Hzlı
Fasten=Bağlamak
Fat=Şişman,yağ
Fate=Kader
Father=Baba
Fault=Kusur
Faultless=Kusursuz
Faulty=Kusurlu
Favour=Lehinde,taraf tutmak
Favourable=İyi,yardımcı
Favourite=Fabori,en sevilen
Fear=Korku
Fearful=Korkutucu
Feather=Tüy,kuş tüyü
Feature=Özellik
February=Şubat
Fed up=Bıkmak
Federal=Federal,federe,grup içinde birleşmiş
Fee=Harç,ücret
Feed=Beslemek
Feel=Hissetmek
Fellow=Arkadaş,kendisine benzeyen arkadaş,adam
Female=Dişi
Fence=Çit
Ferry=Feribot,araba vapuru
Fertile=Gübre,üretken
Fertilize=Gübreleme,döllenme
Festival=Festival
Fetch=Gidip getirmek
Fever=Ateş,vücut ateşi
Few=Az,bir kaç
Fiance=Nişanlı
Fiction=Kurgu,roman kurgusu
Field=Alan
Fig=İncir,çok önemsiz konu
Fight=Kavga,kavga etmek
Figure=Sayı,şekil,vücut
File=Dosya,törpü,sıra
Fill=Doldurmak
Film=Film
Final=Son
Finally=Sonunda
Finance=Finans
Find=Bulmak
Fine=İyi,ince,küçük
Finger=Parmak
Finish=Bitim,bitmek,bitiş
Fire=Yangın,ateş etmek,ateş
Fire-brigade/fire brigade=İtfaiye
Firm=Sert,firma
First=Birinci,ilk
Fiscal=Devlet hazinesine ait,mali
Fish=Balık
Fist=Yumruk
Fit=Uymak,uygun,ani hastalık
Fix=Yapıştırmak,tamir etmek,sabit
Flag=Bayrak
Flake=Tane
Flame=Alev
Flash=Flaş
Flat=Düz,daire
Flavour=Tat
Flea=Pire
Flee=Kaçmak
Fleet=Filo
Flesh=Et,derinin altında ki et
Flight=Uçuş
Flipper=Yüz paleti,yüzgeç
Float=Yüzmek,batmamak
Flock=Sürü
Flood=Sel
Floor=Yapının tabanı,kat
Florist=Çiçekçi,çiçek yetiştiren kimse
Flour=Un
Flower=Çiçek
Fluent=Akıcı
Fly=Uçmak,sinek
Foam=Köpük
Foam rubber=Sünger
Fog=Sis
Fold=Katlamak
Folk=Halk
Follow=İzlemek,takip etmek
Fond=Hoşlanmak,memnun olmak
Food=Yiyecek,besin
Fool=Aptal,aptalca davranmak,kandırmak
Foolish=Aptalca
Foot=Ayak
Football=Futbol
Footprint=Ayak izi
For=İçin
Forbid=Yasaklamak
Force=Zorlamak,zor,fors
Forecast=Tahmin
Forehead=Alın
Foreign=Yabancı,yabancı ülke,yabancı ırk
Foreman=Ustabaşı,formen
Forest=Orman
Forever=Devamlı olarak
Forge=Sahtesini yapmak,demir metale şekil vermek
Forger=Üçkağıtçı,taklitçi
Forget=Unutmak
Forgive=Bağışlamak,affetmek
Fork=Çatal
Form=Şekil,şekillendirmek,form
Formal=Resmi,ciddi
Former=Önceki zaman
Forthwith=Derhal,hemen
Fortnight=İki hafta,ondört gün
Fortune=Servet,alın yazısı,talih
Forward=İleri
Foul=Pis,kirli
Found=İnşa etmek,bulmak,bulunan
Foundtain=Fıskiye
Fountain-pen/Fountain pen=Dolma kalem
Fox=Tilki
Fragile=Kolay kırılabilir
Frame=Çerçeve
Frank=Açık sözlü,samimi
Free=Özgür,rahat,serbest
Free=Bedava,ücretsiz
Freedom=Özgürlük
Freeze=Donmak
Freight=Hamule,navlun
Fresh=Taze
Friday=Cuma
Fridge=Buzdolabı
Friend=Arkadaş
Friendly=Dostça
Fright=Korku
Frighten=Korkutmak
Frog=Kurbağa
From=Den eki,dan eki
Front=Ön
Frontier=Sınır
Frown=Kaşını çatmak,memnun olmak
Fruit=Meyve
Fry=Kızartmak
Fugitive=Kanun kaçığı
Full=Dolu,tamamen
Full stop=Nokta
Fun=Eğlence
Fund=Fon,kullanabilir mali kaynak
Fundamental=Temel,önem,çok gerekli
Funeral=Cenaze
Funny=Komik,garip
Fur=Kürk
Furnish=Döşemek
Further=Daha
Furthermore=Yanında,ayrıca,üstelik
Fuse=Sigorta
Fuss=Telaş,telaşlanmak
Future=Gelecek
