Ufo=Tanımlanmamış uçan cisim,bilinmeyen uçan cisim
Ugly=Çirkin
Umbrealla=Şemsiye
Unable=Muktedir olmamak
Uncle=Dayı,amca
Unconscious=Bilinçsizlik
Under=Altta,alta
Underclothes=İç çamaşırı
Undergo=Katlanmak,çekmek,bir olayın olması
Underline=Yazının altını çizmek,kelimenin altını çizmek,altını çizmek
Understand=Anlamak
Unemployment=İşsizlik
Unfair=Adaletsiz
Unfair=Adil olmayan
Unfavourable=Hoşa gitmeyen
Unhappy=Mutsuz
Unhealthy=Sağlıksız
Uniform=Üniforma,tek tip
Union=Sendika,birleşme
Unit=Birim
Unite=Birleşmek
University=Üniversite
Unknown=Bilinmeyen
Unless=Olmadıkça
Ulikely=Az ihtimalle
Unload=Boşaltmak
Unlock=Kilidi açmak
Until=Kadar
Up=Yukarı,dikine,tümüyle
Up to you=Sana kalmış,nasıl istersen
Upon=üstünde
Upper=Üst
Upset=Endişelendirmek,devirmek
Upside-down=Tepe taklak,ters dönmek
Upstairs=Üst kat,yukarısı
Up to date=Bügüne kadar
Upward=Yukarıya doğru
Urban=Şehirsel,kente ait
Urge=Dürtme,yaptırma,zorlamak
Urgent=Acil
Us=Bize
Use=Kullanım,fonksiyon,kullanmak
Useful=Kullanışlı
Usual=Olağan
