Habit=Alışkanlık
Habitat=Doğal yuva
Hail=Dolu,dolu yağması
Hair=Saç,hayvan tüyü
Hairdresser=Kuaför,berber
Hairdryer=Saç kurutma makinası,saç kurutma makinesi
Half=Yarım
Hall=Hol
Halt=Dur
Ham=Domuz ayağındaki et,domuz ayağında ki et
Hammer=Çekiç,çekiclemek
Hand=El
Hand grenade=El bombası
Handbag=El çantası
Handicap=Sakat
Handkerchief=Mendil
Handle=Tutacak,elinden gelmek,yapabilmek
Handsome=Yakışıklı
Handwriting=El yazısı
Hang=Asmak
Hang on=Bekle
Hangar=Hangar
Happen=Olmak
Happy=Mutlu
Harbour=Liman
Hard=Sert,zor,belalı
Hardly=Zorla,iyi değil
Harm=Zarar,kötülük
Harmful=Zararlı
Harvest=Hasat
Haste=Hız,acele
Hat=Şapka
Hate=Nefret
Have=Sahip olmak
Hawk=Atmaca,el arabasıyla satmak,seyyar satıcılık
Hazard=Tehlike,risk
Head=Baş,kafa
Head quarters=Merkez,karargah
Headache=Baş ağrısı
Headline=Başlık,gazete başlığı
Headphone=Kulaklık
Health=Sağlık
Healthy=Sağlıklı
Hear=Duymak
Heart=Kalp,kupa
Heat=Isı
Heater=Isıtıcı
Heaven=Cennet
Heavy=Ağır
Hectare=Hektar
Heel=Topuk
Height=Yükseklik
Heir=Miraşçı
Hell=Cehennem
Help=Yardım,yardım etmek
Hen=Dişi kuş,piliç
Here=Burası,burada,buraya
Heritage=Miras
Hero=Kahraman
Hesitate=Duraksamak,tereddüt etmek
Hiccup=Hıçkırık
Hide=Saklanmak,saklamak
High=Yüksek
Hijack=Korsanlık yapmak
Hijacker=Korsan,eşkiya
Hill=Tepe,yokuş
Hinge=Menteşe,dayanak noktası,destek
Hire=Kiralamak
History=Tarih
Hit=Darbe,çarpmak,popüler
Hitch-hike/hitch hike=Otostop yapmak
Hobby=Hobi
Hold=Tutmak,kavramak
Hold on=Bekle
Hole=Delik
Holiday=Tatil günü
Hollow=Boş
Holy=Kutsal
Home=Ev,yuva
Homesick=Sıla hasreti
Honest=Dürüst
Honey=Bal
Honeymoon=Balayı
Honour=Onur
Hook=Çengel,kanca
Hop=Sıçramak,zıplamak,sekmek
Hope=Umut
Hopeless=Umutsuz
Horizon=Ufuk
Horizontal=Yatay
Horn=Boynuz,korna
Horrible=Korkunç
Horse=At
Hose=Hortum
Hospital=Hastane
Host=Ev sahibi
Hostage=Esir,rehine
Hostel=Öğrenci,turist konaklama yeri
Hot=Sıcak,acı
Hotel=Otel
Hour=Saat
Hourly=Saat başı
House=Ev
Housewife=Ev hanımı
Hover=Havada kalmak
How=Nasıl
However=Her şekilde
Hubbub=Gürültü
Hug=Sarılmak,kucaklamak
Huge=Çok büyük
Hum=Vızıldamak,dudak kapalı şarkı söylemek,mırıldanmak
Human=İnsan,beşeri
Humble=Alçal gönüllü
Humour=Güldürü,mizah
Hungry=Aç
Hunt=Avlamak
Hurry=Acele etmek
Hurt=Yaralamak,yaralanmak
Husband=Koca,erkek eş
Hush=Sakinlik,sessizlik,sus
Hut=Kulübe,baraka
