Cab=Taksi
Cabbage=Lahana
Cabin=Kabin
Cabinet=Kabine
Cable=Kablo,telgraf
Cage=Kafes
Cake=Kek
Calculate=Hesaplamak
Calendar=Takvim
Calf=Baline yavrusu,buzağı,baldır
Call=Çağırmak,aramak,kısa ziyaret
Calm=Sakin
Camel=Deve
Camera=Kamera
Candidate=Aday
Candle=Mum
Cannon=Top
Caneen=Kantin
Capacity=Kapasite
Capital=Başkent,sermaye,büyük harf
Captain=Kaptan,yüzbaşı
Capture=Ele geçirmek,hapse atmak
Car=Araba
Caravan=Karavan
Care=Dikkat,özen
Career=Meslek
Careful=Dikkatli
Careless=Dikkatsiz
Cargo=Kargo
Carnival=Karnaval
Carpenter=Marangaz
Carpet=Halı
Carriage=Fayton,vagon
Carrier=Taşıyıcı
Carrot=Havuç
Carry=Taşımak
Case=Kutu,kap,dava
Cash=Nakit
Cash-register=Yazar kasa
Castle=Kale
Casual=Planlanmıyan,normal,sade
Cat=Kedi
Catch=Yakalamak
Caterpillar=Tırtıl
Cattle=Büyükbaş hayvan
Cause=Neden,neden olmak
Catuion=Uyarı
Cave=Mağara
Cease-fire=Ateş-kes,ateş kes
Ceiling=Tavan
Celebration=Kutlama
Cell=Hücre,hapis,beyin
Cellar=Kiler,bodrum
Cement=Çimento
Central=Mekrezi
Centre=Orta,merkez
Century=Yüzyıl
Cereal=Tahıl,mısır
Certain=Kesin,belirli,emin olmak
Certainly=Kuşkusuz
Certificate=Sertifika
Chain=Zincir
Chair=Sandale,koltuk,iskemle
Chairman=Yönetim kurulu başkanı
Chalk=Tebeşir
Challenge=Meydan okuma
Champagne=Şampanya
Champion=Şampiyon
Championship=Şampiyona
Chance=Şans,fırsat
Change=Değişmek,değişim,bozuk para
Channel=Kanal
Chapter=Bölüm,konu
Character=Karakter,kişilik
Charge=Doldurmak,masrafa yazmak
Charity=Hayır severlik,yardım severlik,yardım sever
Charlatan=Şarlatan
Charm=Çekicilik
Charming=Çekici
Chart=Tablo,çizelge
Charter=Patent,berat,devlet onaylı
Chase=Kovalamak
Chat=Sohbet,çene çalmak
Chatter=Gevezelik yapmak
Cheap=Ucuz
Cheat=Hileci,hile yapmak,kopya çekmek
Check=Kontrol etmek
Cheek=Yanak,popo
Cheeky=Yüzsüz,kaba,kibar olmayan
Cheer=Neşe,çoşturmak
Cheerful=Neşeli,şen,mutlu
Cheeser=Peynir
Chef=Şef,ahçı
Chemical=Kimyasal
Cherry=Kiraz
Chess=Santraç
Chest=Göğüş,sandık
Chestnut=Kestane
Chewing-gum/Chewing gum=Sakız
Chicken=Piliç
Chief=Şef
Child=Çocuk
Childhood=Çocukluk
Chilli=Çok acı
Chilly=Rahatsız edici soğuk,çok soğuk,fazla soğuk
Chimney=Baca
Chin=Çene
Chip=Ufak parça
Chocolate=Çikulata,çikolata
Choice=Seçim,istek,tercih
Choke=Boğma,tıkama,jikle
Choose=Seçmek
Chop=Kesmek,yarmak,pirzola
Chuckle=Kıkırdama
Church=Kilise
Cigar=Puro
Cigarette=Sigara
Cinema=Sinema
Circle=Çember,grup,çevre
Circuit=Devre
Circular=Yuvarlak,çembersel,sirküler
Circumstances=Durum,vaziyer
Circus=Sirk
Citizen=Yurttaş
City=Kent,site
Civic=Kente ait
Civil=Sivil
Claim=İleri sürmek,savlamak
Claimant=Davacı,mahkemeden hak talep eden
Clap=Alkışlamak
Clasp=Sıkıca tutmak
Class=Sınıf
Classic=Klasik
Clay=kil
Clean=Temiz,temizlemek
Clear=Açık,berrak,ortalığı toplamak
Clerk=Memur
Clever=Akıllı
Client=Müşteri,müvekkil
Climate=İklim
Climb=Tırmanmak,yükselmek
Clinic=Klinik
Clip=Kırpmak,kesmek,klips
Cloakroom=Vestiyer,tuvalet
Clock=Saat
Close=Yakın
Close=Kapalı,kapatmak,son
Cloth=Bez
Clothes=Giysiler
Cloud=Bulut
Clown=Palyaço
Club=Klüp,sinek
Clue=İpucu
Clutch=Kavrama,debriyaj
Co=Beraber
Coach=Antrenör,yolcu vagonu,şehirlerarası otobüs
Coal=Kömür
Coast=Kıyı,sahil
Coat=Palto
Cobweb=Örümcek ağı
Cock=Horoz,erkek kuş,penis
Cocoa=Kakao
Coconut=Hindistan cevizi
Code=Kod
Coffee=Kahve
Coffin=Tabut
Coin=Madeni para
Cold=Soğuk
Collapse=Çökmek,katlamak
Collar=Yaka,tasma
Colleague=Meslektaş
Collect=Toplamak
Collective agreement=Toplu sözleşme
Colonel=Albay
Color=Renk
Colour=Renk
Column=Sütun
Coma=Koma,koma hali
Comb=Tarak
Come=Gel,gelmek
Come across=Tesadüfen karşılaşmak,tesadüfen bulmak
Comet=Kuyruklu yıldız
Comfort=Konfor,rahat
Comfortable=Konforlu
Command=Kumanda etmek,yönetmek,yönlendirmek
Commemorate=Anmak,kötü anmak
Commence=Başlamak
Commercial=Ticari,reklam
Commission=Atamak,görevlendirmek,komisyon
Commit=Suç işlemek
Commitment=Taahhüt,sorumluluk
Common=Basit,ortak,müşterek
Communicate=İletişim
Community=Toplum
Commute=Evden işe gitmek,uzun yol gitmek
Company=Şirket,beraberlik,arkadaşlık
Comparatively=Mukayeseli olarak
Compare=Mukayese etmek
Compass=Pusula,pergel
Compensate=Telafi etmek,karşılamak
Compensation=Telafi,tazminat
Compete=Yarışmak
Competition=Yarışma,rekabet
Complain=Yakınmak,şikayet etmek
Complete=Bütün,tamamı,bitmiş
Complicated=Karışık,komplike
Compliment=İltifat,kompliman,hediye
Components=Unsur,parça,bileşimde bulunan
Compose=Yapım
Composition=Kompozisyon,birleşik
Compound=Birleşik,bileşik
Compromise=Uzlaşma
Computer=Bilgisayar
Concentrate=Konsantre,yoğun
Concept=Genel fikir,düşünce,anlayış
Concern=İlgilendirmek,üzülmek
Concern=İlgi,üzüntü,endişe
Concert=Konser
Conclude=Sonuca ulaşmak,karar vermek
Conclusion=Karar,sonuç
Condemn=Cezalandırmak,mahkum etmek,zorunlu kılmak
Condition=Durum,şart
Conduct=Davranış,tavır,yol göstermek
Cone=Koni,külah
Conference=Konferans
Confess=İtiraf etmek
Confidence=Güven
Confine=Kuşatmak,hapsetmek,sınırlamak
Conflict=Kafası karışmak,şaşırmak
Congratulate=Kutlamak
Connect=Birleştirmek,bağlanmak
Conquer=İşgal etmek
Conscience=Vicdan,bilinç
Conscious=Bilinçli
Consent=Kabul etmek,onaylama
Consequently=Bundan dolayı,sonuç olarak,sonunda
Consider=Göz önüne almak,düşünmek
Consideration=Düşünüş,tartış
Consign=Satış için gönderme,başkasına devretme
Consist=Oluşmak
Consistent=Tutarlı,uyumlu
Constitute=Oluşmak,kurmak
Constitution=Anayasa
Construct=İnşa etmek,yapmak
Consul=Konsolos
Consult=Danışmak
Consultation=Toplantı,konsültasyon
Consume=Tüketmek
Consumption=Tüketim
Contact=Temas,dokunma
Contain=Kapsamak
Container=Kap
Content=Tatmin olmuş
Contents=İçerik
Contest=Yarışma
Continent=Kıta
Continuous=Sürekli
Contract=Kontrat,anlaşma
Contrary=Tersine,zıddına
Contrast=Karşılaştırmak
Contribute=Katkıda bulunmak
Control=Kontrol,kontrol etmek,yönetmek
Convenience=Uygunluk,kolaylık
Convenient=Elverişli,uygun
Conversation=Söyleşi
Convict=Mahkum,suçlu
Convince=İkna etmek
Cook=Aşçı,yemek pişirmek
Cool=Serin,serinletmek,havalı
Co-operate=Birlikte çalışmak
Cop=Polis
Cope=Başa çıkmak,ayak uydurmak
Copper=Bakır
Copy=Kopyalamak,taklit etmek,kopyala
Cordon=Polis,asker kordonu
Cork=Mantar
Corn=Ekin,mısır,nasır
Corner=Köşe
Corpse=Ceset
Correct=Hatasız,düzeltmek
Correspondent=Mektuplaşmak,mektuba cevap veren,muhabir
Corridor=Koridor
Corruption=Rüşvetçilik,yolsuzluk
Cosmetic=Kozmetik
Cost=Maliyet,mal olmak
Costly=Pahalı
Costume=Kostüm
Cottage=Köy evi
Cotton=Pamuk
Cough=Öksürmek,öksürme
Council=Konsey
Count=Saymak
Country=Ülke,kırlık alan
Coupe=Spor araba
Couple=Çift,bir kaç
Coupon=Kupon
Courage=Cesaret
Course=Gidişat,kurs
Court=Mahkeme,kort
Cousin=Kuzen
Cover=Kaplamak
Cow=İnek
Coward=Korkak
Crack=Kırmak
Cracker=Kraker
Cramp=Kramp
Crane=Vinç ile kaldırmak,vinç
Crash=Çarpışmak,çarpıştırmak
Crazy=Çılgın
Cream=Krema,krem,kirli beyaz
Creation=Yaratış
Creature=Yaratık
Credit=Kredi
Crime=Suç
Criminal=Suçlu
Crisis=Kriz
Crisp=Cips,kızarmış patates,kızarmış kuru patates
Crisp=İnce,kaş
Critical=Kritik
Criticize=Eleştirmek
Crocodile=Timsah,afrika timsahi
Crop=Ürün,toprak ürünü
Cross=Karşıdan karşıya geçmek,çarplazlama gitmek,haç
Crossing=Geçit
Crossroads=Kavşak
Crossword=Çarpraz bulmaca
Crow=Karga,horoz ötüşü
Crowd=Kalabalık
Crown=Taç
Crucial=En önemli an,önemli karar
Crude=Petrol
Cruel=Zalim
Cruise=Deniz gezisi,kıtalararası silah
Crush=Kırmak
Cry=Ağlamak,bağırmak
Cube=Küp
Cucumber=Hıyar
Cultivate=Toprakla uğraşmak
Culture=kültür
Cup=Fincan,kupa
Cure=İyileştirmek,tedavi,işlem
Curiosity=Merak
Curious=Meraklı,olağandışı
Curl=Kıvırmak
Current=Akım,cari,kur
Curry=Hafif acılı
Curse=Lanet
Curtain=Perde
Curve=Eğri
Cushion=Yastık
Custom=Gelenek,özel
Customer=Alıcı,müşteri
Customs=Gümrük
Cut=Kesmek,kes
Cycle=Bisiklet,tur
Cylinder=Silindir
