Each=Her,her biri
Eager=İstekli
Eagle=Kartal
Ear=Kulak
Early=Erken
Earn=Para kazanmak
Earnest=Ciddi
Earth=Dünya,toprak,toprak parçası
Earthquake=Deprem
Ease=Kolaylık
East=Doğu
Easy=Kolay
Eat=Yemek,yemek yemek
Echo=Eko,akis
Economical=Ekonomik
Edge=Kenar
Editor=Editör
Educate=Eğitim
Eel=Yılan balığı
Effect=Efekt,etki
Efficient=Etkin,iyi çalışan
Effort=Efor
Egg=Yumurta
Either=Ya da,ne de,ya o ya bu
Elapse=Zamanın geçmişi
Elastic=Elastik
Elbow=Dirsek
Elder=Yaşlı,daha yaşlı
Elect=Seçmek
Election=Seçim
Electricity=Elektrik
Elegant=Şık
Elementary=Temel,başlangıç,başlangıç için
Elephant=Fil
Else=Daha,başka
Elserhere=Başka bir yer
Embark=Birşey yapmaya başlamak,gemi yada uçakla gitmek
Embarrassment=Sıkıntı,utanmak
Embassy=Büyükelçilik,büyük elçilik
Embrace=Sarılmak
Emerge=Çıkmak
Emergency=Acil durum
Emigrate=Göçmen,kendi ülkesinden göçen
Emotion=Kuvvetli duygu
Emphasis=Önemli,şiddetli vurgu
Emphasize=Üzerinde durmak
Emphatic=kesinlikle,mutlak,kesin
Empire=İmparatorluk
Employ=Çalıştırmak,parayla adam çalıştırmak
Employee=Çalıştırılan adam
Employer=İşveren
Employment=İş
Empty=Boş
Enclose=Kapatmak,etrafını kapatmak
Encourage=Cesaretlendirmek
End=Son,bitirmek,bitiş
Endorsement=Tastik,onay,ciro
Enemy=Düşman
Energy=Enerji
Engage=Nişanlamak,iş vermek
Engine=Makine,makina
Enjoy=Eğlenmek,eğlenceli
Enormous=Kocaman,iri
Enough=Yeter
Enter=Girmek,katılmak
Enterprise=Girişim
Entertain=Ağırlamak,konukları ağırlamak
Entertainment=Eğlence
Entitle=Yetki vermek,hak vermek
Entrance=Giriş
Envelope=Zarf
Epitaph=Mezar taşı yazısı
Equal=Eşit
Equality=Eşitlik
Equalize=Eşitlemek
Equip=Donatmak,giyinmek,kuşanmak
Equipment=Tesisat,donanım
Erect=Kaldırmak
Error=Hata
Escalator=Yürüyen merdiven
Escape=Kaçmak
Escort=Konvoy,refakat
Especial=Özel,önemli
Establish=Kurmak,inşa etmek
Estate=Mal,mülk,arsa
Estimate=Tahmin etmek,hesaplayarak tahmin etmek
Evacuate=Boşaltmak,tahliye etmek,tehlikeden uzaklaştırmak
Even=Hatta,çift,berabere
Evening=Akşam
Event=Olay
Eventually=Sonunda,nihai
Ever=Herhangi bir zaman
Every=Her
Evidence=Delil
Evil=Kötü
Evolution=Evrim
Ex=Sabık,eski
Exact=Tam
Exactly=Kesin olarak
Exaggerate=Abartmak
Examine=İncelemek,sınav vermek
Example=Örnek
Exceed=Aşırı
Excellent=Çok iyi
Except=Dışında,hariç
Exception=İstisna
Exchange=Değiş tokuş,takas
Excite=Heyecanlandırmak
Exclaim=Bağırmak
Exclude=Dışlamak
Exclusive=Umuma açık olmayan,başkalarıyla paylaşılmayan,gizli tutulan
Excuse=Affetmek,muaf tutmak,mazeret
Execute=Yapmak,yerine getirmek,infaz etmek
Exercise=Egzersiz
Exhaust=Yorulma,bitme,egzos
Exhibit=Teşhir etmek,göstermek
Exhibition=Sergi
Exist=Oluş,var olmak
Exit=Çıkış,çıkmak
Expand=Büyümek,genişlemek,daha samimi ve konuşkan olmak
Expansion=Genişleme,büyüme,ek
Expect=Ummak,beklemek
Expense=Masraf
Expensive=Pahalı
Experience=Tecrübe
Experiment=Deney
Expert=Bilirkişi,uzman,eksper
Expire=Sürenin dolması
Explain=Açıklamak
Explanation=Açıklama
Explode=Patlamak,bomba patlaması
Explore=Araştırmak,bir yeri araştırmak
Explosive=Patlayıcı madde
Export=İhraç malı,ihracat
Express=İfade etmek
Expression=İfade
Extend=Genişletmek,büyütmek
Extension=Genişletme,büyütme
Extent=Boyut,büyüklük
Extinguish=Işığı söndürmek,ateşi söndürmek, ateşi veya ışığı söndürmek
Extra=Fazla,ekstra
Extract=Çekip çıkartmak,çıkartmak
Extraordinary=Olağandışı
Extreme=Son derece,aşırı
Eye=Göz
Eyebrow=Kaş
Eyelash=Kirpik
Eyelid=Göz kapağı
