Table=Masa,tablo,liste
Tablet=Tablet
Taboo=Ayıp,argo,tabu
Tail=Kuyruk
Tailor=Terzi
Take=Tutmak,almak
Talent=Kabiliyet,üstün,seksi cazibesi olan kadın
Talk=Konuşma,konuşmak
Talkative=Konuşkan
Tall=Uzun
Tame=Evcil,evcilleştirmek
Tan=Ten rengi
Tangerine=Mandalina
Tank=Tank
Tap=Musluk,tıklatmak
Tape=Bant,seloteyp
Target=Hedef
Tariff=Tarife,fiyat listesi
Tart=Turta,pasta,sokak kadını
Task=Görev
Taste=Tatmak,tad
Tax=Vergi
Taxi=Taksi
Tea=Çay
Teach=Öğretmek
Teacher=Öğretmen
Team=Takım,grup
Tear=Gözyaşı,delik,yırtmak
Tease=Kızdırma,yüz verip sonra sırt çevirme,kabartma
Technique=Teknik
Teenager=Genç,delikanlı
Telegram=Telgraf
Telephone=Telefon
Telescope=Teleskop
Television=Teleizyon
Tell=Anlatmak,söylemek
Temper=Ruhsal durum,kızgın
Temperature=Sıcaklık
Temple=Tapınak
Temporary=Geçici
Tempt=Cezbetmek,şeytana uydurmak
Tenant=Kiracı
Tend=Meyilli olmak
Tender=Kolay çiğnenebilen,yumuşak,iyi huylu
Tent=Tente,çadır
Term=Zaman dilimi,sözcükler,sömestr
Terminal=Terminal
Terrace=Bitişik evler
Terrible=Korkunç,kötü
Terrific=Kocaman,çok güzel
Terrify=Korkutmak
Territory=Korkutmak
Territory=Toprak parçası
Terror=Büyük korku,terrör
Test=Sınamak,denemek,test
Than=Den eki,dan eki
Thank=Teşekkür etmek
Theatre=Tiyatro
Their=Onların
Them=Onları
Theme=Tema,konu
Then=Öyleyse,o zamanda,ondan sonra
Theory=Teori
There=Orada,var olmak
Therefore=Dolayısıyla
Thermometer=Termometre
These=Bunlar
They=Onlar
Thick=Kalın,sık
Thief=Hırsız
Thin=İnce
Thing=Şey
Think=Düşünmek,düşünme
Third=Üçüncü
Thirsty=Susamışlık,susatan
Thirteenth=Onüçüncü
Thirtieth=Otuzuncu
This=Bu
Thorough=Tümüyle,dikkatli
Thoroughly=Tamamıyla,bütün ince detaylarıyla
Those=Onlar
Though=Nedense
Thought=Düşünce
Thoughtful=Düşünceli,öbürlerini düşünen
Thoughtless=Düşüncesiz
Thread=İp,ipi iğneye yağmak,lif
Threat=Tehdit
Threaten=Tehdit etmek
Throat=Gırtlak,yemek borusu
Through=İçinden,baştan sona
Throw=Fırlatmak
Thumb=El,baş parmağı
Thunder=Gök gürültüsü
Thunderstorm=Fırtına
Thursday=Perşembe
Thus=Böyle,böylece
Tick=Saat sesi,okey işareti
Ticket=Bilet
Tide=Gel-git olayı,gel git olayı
Tidy=Düzenli,derli toplu
Tie=Bağ,bağlamak,berabere
Tiger=Kaplan
Tight=Sıkı,kolay açılmaz
Till=Kadar,yazar kasa
Time=Zaman,kere,zamanlamak
Tin=Teneke,konserve
Tiny=Çok küçük
Tip=Bahşiş,öneri,tavsiye
Tire=Yormak
Tired=Yorgun
Tissue=Kağıt mendil
Title=Başlık,ünvan
To=E kadar
Toast=Tost,tost yapmak,kadeh kaldırmak
Tobacco=Tütün
Today=Bugün
Toe=Ayak başparmağı,ayak baş parmağı
Together=Birlikte
Toilet=Tuvalet
Token=İşaret,jeton
Tomato=Domates
Tomorrow=Yarın
Ton=Ton
Tone=Ton
Tongue=Dil
Tonight=Bu gece
Too=Çok,de eki,da eki
Tool=Alet
Tooth=Diş
Tooth pick=Kürdan
Top=En yüksek,en iyi,üst
Topic=Konu
Torch=Meşale,el feneri
Torpedo=Torpil
Tortoise=Kaplumbağa
Torture=İşkence,işkence etmek
Total=Toplam
Totally=Bütünüyle
Touch=Dokunmak
Tough=Zor,güç,sert
Tour=Tur
Tournament=Turnuva
Towards=Doğru
Towel=Havlu
Tower=Kule
Town=Kasaba
Toy=Oyuncak
Trace=İz,iz sürmek
Tack=İz sürmek,takip etmek
Trade=Ticaret,iş
Tradition=Gelenek
Traffic=Trafik
Tragedy=Trajedi
Train=Eğitmek,staj yapmak,tren
Training=Eğitim,öğretim
Transfer=Transfer
Transform=Dönüştürmek
Trnslate=Çeviri,tercüme
Transparent=Saydam
Transport=Taşımacılık
Trap=Tuzak,kapan,yakalamak
Travel=Yolculuk,yolculuk yapmak
Tray=Hepsi
Treasure=Hazine
Treat=Davranmak,muamele etmek,ikram
Treatment=Davranış,tedavi
Tree=Ağaç
Tremendous=Çok büyük,harika
Trial=Deneme,teşebbüs,duruşma
Tribe=Kabile
Trick=Hile,hile yapmak,oyun
Trigger=Tetik
Trip=Gezi,çelme takmak
Tripod=üç ayaklı sehpa,sehpa,tripod
Triumph=Zafer,utku
Troop=İnsan grubu,hayvan grubu,sürü
Troops=Askerler
Trouble=Dert,dert etmek
Trousers=Pantolon
Truck=Kamyon
Trunk=Ağaç gövdesi,sandık,fil hortumu
Trust=Güvenmek
Turth=Gerçek
Try=Denemek,deneme
Tube=Tüp
Tuesday=Salı
Tuition=Öğretim,özel ders
Tulip=Lale,lale fidanı
Tummy=Mide
Tune=Akord etmek,ayarlamak,ezgi
Tunnel=Tünel
Turban=Türban
Turkey=Türkiye
Turn=Dönmek,dönüş
Turnkey=Anahtar teslim,teslim
Turnover=Ciro
Twice=İki kez
Twist=Çevirmek,kıvırmak,burkmak
Type=Çeşit,tip,daktiloyla yazmak
Typical=Tipik
Typist=Daktiloda yazı yazan kimse
Tyre=Lastik
