Jack=kriko,vale,torpil yaptırmak
Jackal=Çakal
Jacket=Ceket
Jaguar=Jaguar
Jail=Hapis
Jam=Reçel,sıkışıklık
January=Ocal,ocak ayı
Jar=Kavanoz
Jaw=Çene kemiği,çene çalmak,konuşmak
Jazz=Caz
Jealous=Kıskanç
Jeans=Jin,kot pantolon,kot
Jelly=Jöle
Jellyfish=Denizanası,medüs,su medüsü
Jet=Jet,fışkırtmak
Jewel=Mücevher
Job=İş
Jocket=Cokey
Join=Katılak,birleştirmek,birleşme
Joint=Birleşik
Joke=Şaka
Jolly=Çok
Journal=Gazate,dergi
Journalist=Gazeteci
Journey=Yolculuk
Joy=Mutluluk,eğlence
Jubilee=Jübile
Judge=Hakim,yargılamak
Judgement=Yargı
Juice=Su,meyve suyu
July=Temmuz
Jump=Sıçaramak,atlamak
June=Haziran
Jurry=Jüri
Just=Yalnız,sadece,hemen şimdi
Justice=Adalet
