Ability=Yetenek,kabiliyet,beceri
Aboard=Bir taşıtın içinde olmak
Abolish=Ortadan kaldırmak,feshetmek,iptal etmek
About=Hakkında,yaklaşık olarak,ilgili
Above=Yukarıdaki,her şeyden önce,üstü
Abroad=Yurt dışı
Absent=Yok,eksik,bulunmayan
Absolute=Mutlak,kesin
Absorb=Emmek,karşılamak,fikir almak
Absurd=Saçma,anlamsız,mantıksız
Abuse=Kötüye kullanma,suistimal,küfür
Academic=Akademik,bilimsel,teorik
Accelerator=Gaz pedalı,hızlandırıcı,sempatik sinir
Accent=Şive,aksan
Accept=Kabul etmek,onaylamak,üstlenmek
Access=Erişim,giriş,yol
Accessible=Kolay bulunur,içine girilebilinir,ulaşılabilir
Accident=Kaza,tesadüf,rastlantı
Accommodation=Konaklama yeri,kalacak yer
Accompany=Eşlik etmek,katılmak,yanında olmak
According to/according=Göre
Account=Hesap
Accounting=Muhasebe
Accumulate=Toplamak,biriktirmek
Accurate=Doğru,hatasız
Accuse=Suçlamak
Accused=Sanık,suçlamak
Accustom=Alıştırmak
Accustomed=Alışık,alışkın
Ache=Ağrı
Achieve=Üstünden gelme,erişmek,başarmak
Achievement=Başarı
Acid=Asit
Acknowledge=Doğrulamak
Acquire=Edinmek
Acquisition=Edinme,istimlak,el koyma
Across=Bir uçtan diğerine,diğer tarafa
Act=Davranış,davranmak
Active=Etkin,faal
Actor=Erkek oyuncu
Actress=Kadın oyuncu
Actual=Gerçek
Add=Toplamak,eklemek
Addict=Tiryaki,müptela
Address=Adres
Administration=İdare
Admiral=Amiral
Admire=Beğenmek,hayran olmak
Admission=Kabul,itiraf,giriş
Admit=Kabul etmek,izin vermek
Adopt=Kabul etmek,evlat edinmek
Adult=Yetişkin
Advance=İleri,avans
Advanced=Gelişmiş
Advantage=Avantaj
Adventure=Macera
Advertise=Reklam yapmak,ilan vermek
Advice=Tavsiye
Advise=Tavsiye etmek
Aerial=Anten
Aeroplane=Uçak
Affair=Olay,iş,ilişki
Affect=Etkilemek
Afford=Gücü yetmek,parası yetmek,zaman ayırabilmek
Afraid=Korkmak,korkan,korkmuş
After=Sonra
Afternoon=Öğleden sonra
Afterwards=Sonra,bir olaydan sonra
Again=Bir daha,yine,tekrar
Against=Karşı,zıt
Age=Yaş,çağ
Aged=Yaşında
Agency=Acente
Agent=Temsilci,aracı
Aggressive=Saldırgan,kavgacı,agresif
Ago=Önce
Agree=Anlaşmak,kabul etmek,onaylamak
Agreement=Anlaşma
Agriculture=Tarım
Ahead=Önde
Aid=Yardım
Aim=Amaç,hedef,hedef almak
Air=Hava,havalandırma
Airport=Hava alanı
Alarm=Alarm
Album=Albüm
Alcohol=Alkol
Algebra=Cebir
Alike=Hemen hemen aynı,benzer,aynı yolda
Alive=Yaşamak,canlı
All=Hepsi,tümü,herkes
Alliance=İttifak,birlik,mütareke
Alligator=Timsah
Allow=İzin vermek
Allowance=Düzenli sağlanan para,harçlık
Almost=Hemen hemen
Alone=Yalnız,tek
Along=Boyunca,ileri
Aloud=Sesli
Alphabet=Alfabe
Already=Az önce,zaten
Also=Hem de,hem
Alter=Değiştirmek
Alternative=Alternatif,seçenek
Although=Gerçi,olmakla beraber
Altogether=Tümüyle,hep beraber
Always=Her zaman
Amateur=Amatör
Amaze=Şaşırtmak
Ambition=Hırs
Ambulance=Ambulans
Amend=Düzelme,ayarlama
Among=Arasında
Amount=Miktar
Amuse=Güldürmek
And=Ve
Angel=Melek
Anger=Kızmak,sinirlenmek
Angle=Açı,köşe
Angry=Kızgın
Animal=Hayvan
Ankle=Ayak bileği
Anniversary=Yıldönümü,yıl dönümü
Announce=Bildirmek,çağrıda bulunmak,anons
Annoy=Rahatsız etmek,kızdırmak
Annual=Yıllık
Another=Diğer,bir başka
Answer=Yanıt
Ant=Karınca
Anti=Karşı,zıt,ters
Anticipate=Beklemek,sezmek,tahmin etmek
Antique=Antika
Anxiety=Endişe
Anxious=Endişeli
Anxiously=Endişeli olmak
Apart=Ayrı
Apart from=Hariç,dışında
Apartment=Apartman,apartman dairesi
Ape/monkey=Maymun
Apologize=Özür dilemek
Apparent=Açık,kolayca görünen
Apparently=Bariz olmak,görünmek
Appear=Görünmek
Appearance=Görünüş
Appetite=İştah
Apple=Elma
Applicant=Başvuran
Application=Başvuru
Apply=Başvurmak,uygulamak
Appoint=Atamak
Appointment=Randevu,atama
Appreciate=Müteşekkir,değer bilmek,beğenmek
Approach=Yaklaşma,yaklaşım,geliş
Approve=Onaylamak
Approximate=Yaklaşık olarak
Apricot=Kayısı
April=Nisan
Architect=Mimar
Architecture=Mimari
Area=Alan,bölge
Argue=Tartışmak,tartışma
Argument=Tartışma
Arise=Kalkmak,yükselmek
Arm=Kol,silah
Armchair=Koltuk
Armour=Zırh
Army=Ordu
Around=Aşağı yukarı,çevre
Arrange=Düzenlemek,ayarlamak
Arrest=Tutuklamak
Arrival=Varış
Arrive=Varmak
Arrow=Ok
Art=Sanat,resim
Article=Makale,eşya
Artificial=Yapay
Artist=Sanatçı
As=Gibi,olarak
Ash=Kül
Ashamed=Utanmış
Aside=Bir yanda
Ask=Sormak,sitemek,soru sormak
Asleep=Uykuda
Aspect=Görüş,görünüş,durum
Assembly=Montaj,oturum
Asset=Varlık
Assist=Yardım etmek
Assistant=Yardımcı
Associate=İlgilenmek,birleştirmek
Association=Cemiyet,birlik,aynı şeyle ilgili olan
Assume=Varsaymak
Assurance=Güven,inanç,söz
Assure=Temin etmek,söz vermek,ikna etmek
Assured=Önceden belli,kendine güvenen
Astonish=Şaşırtmak
At=De eki,da eki
Atmosphere=Atmosfer,havaküre
Attach=Birleştirmek
Attachment=İlave,ek
Attack=Saldırmak,atak
Attempt=Denemek
Attend=Katılmak,bulunmak,bir yerde bulunmak
Attention=Dikkat
Attitude=Yaklaşım,hareket,tavır
Attractive=Çekici
Auction=Müzayede,mezat
Audience=İzleyici
Augment=İlave etmek,arttırmak,zam yapmak
August=Ağustos
Aunt=Teyze,hala
Author=Yazar
Authority=Otorite
Autumn=Sonbahar
Available=Hazır,serbest,boşta
Avenue=Cadde
Average=Ortalama
Avoid=Kaçınmak
Awake=Uyanış
Award=Mükafat
Aware=Bilgili,farkında olmak,haberdar olmak
Away=Buradan,burada değil,uzakta
Awful=Kötü,berbat,üzücü
Axe=Balta
