Gain=Kazanmak
Gallery=Galeri
Gamble=Kumar oynamak,kumar
Game=Oyun
Gang=Çete
Gaol=Hapishane
Gap=Boşluk,fark
Garage=Garaj
Garden=Bahçe
Garlic=Sarımsak
Gas=Gaz
Gate=Bahçe kapısı
Gather=Toparlamak,toplanmak,anlamak
Gay=Mutlu,çok renkli,homo
Gear=Vites
General=General,genel
Generally=Genellikle
Generous=Cömert
Genius=Dahi
Gentle=Nazik
Gentleman=Centilmen
Germ=Mikrop
Get=Almak,elde etmek,anlamak
Ghost=Hayalet,hortlak
Gift=Armağan,yetenek
Gigolo=Jigolo
Ginger=Zencefil,hafif kahverengi
Gipsy=Çingene
Girl=Kız
Give=Vermek
Glad=Memnun
Gladly=Zevkle
Glass=Cam,bardak
Globa=Küre,dünya
Glorious=Parlak,onurlu
Glory=Onur,heyecan,güzellik
Glove=Eldiven
Glue=Yapıştırıcı
Go=Gitmek
Goal=Gedef,gaye,gol
Goat=Keçi
God=Tanrı
Gold=Altın
Golden=Altından
Goldfish=Akvaryum balığı
Good=İyi,devamlı,uzun periyot
Good-looking/good looking=İyi görünümlü,yakışıklı
Goose=Kaz
Gosh=Hayret
Gossip=Dedikodu,dedikodu yapmak
Govern=Yönetmek,hükmetmek
Government=Hükümet
Graduate=Mezun,üniversite mezunu
Grain=Tanecik
Grand=Büyük,zevkli
Grape=Üzüm
Grapefruit=Greyfurt
Grasp=Sıkıca tutmak
Grass=Ot,muhbir,ispiyoncu
Grateful=Minnettar
Grave=Mezar,kötü,önemli
Gravestone=Mezartaşı
Graveyard=Mezarlık,mezar
Great=Büyük,çok,çok iyi
Green=Yeşil,tecrübesiz,toy
Greengrocer=Manac
Greeting=Kutlama
Grey=Gri
Grill=Gril
Grip=Sıkıca tutmak
Grocer=Bakkal
Groom=Damat
Ground=Yer,toprak
Group=Grup,topluluk
Grow=Büyümek,yetişmek
Grumble=Sızlanmak,yakınmak
Guarantee=Garanti
Guard=Korumak
Guerrilla=Gerilla
Guess=Tahmin etmek
Guest=Konuk,misafir
Guided=Rehber,rehberlik etmek
Guilt=Suç,kabahat
Guitar=Gitar
Gulf=Körfez
Gum=Yapışkan,diş eti
Gun=Silah
Guy=Adam
