Rabbit=Tavşan
Race=Irk,yarışmak
Radiator=Radyatör
Rail=Ray
Railing=Bahçe parmaklıkları
Railway=Tren yolu
Rain=Yağmur
Raincoat=Yağmurluk
Raise=Yükseltmek,zam yapmak,yetiştirmek
Rank=Sıra,rütbe,sosyal sınıf
Rapid=Çabuk,hızlı
Rare=Nadir
Rat=Sıçan
Rate=Hız,oran
Rather=Ham,çiğ
Razor=Ustura,traş makinesi
Reach=Erişmek
Read=Okumak
Ready=Hazır
Realize=Fark etmek
Really=Gerçekten
Rear=Yetiştirmek,arka,arka taraf
Reason=Neden,akıl
Reasonable=Makul,uygun
Receipt=Makbuz
Receive=Almak,karşılamak
Recent=Yakın zamanda olan
Reception=Resmi davet,resepsiyon
Recession=Duraklama,gerileme,ekonomide durgunluk
Decipe=Yemek tarifi
Recognize=Tanımak
Recollect=Hatırlamak
Recommend=Tavsiye etmek
Record=Kayıt,plak,rekor
Recover=İyileşmek,bulmak,kaybedilen bir şeyi bulmak
Red=Kırmızı,kızıl
Reduce=Azaltmak
Referee=Hakem
Reflect=Yansıtmak
Refreshments=Sandiviç,tost,içecek
Refrigerator=Buzdolabı
Refuge=Refüj,güvenilir yer
Refugee=Tehlikeden kaçan,kazazede
Refuse=Reddetmek
Regard=Dikkat,düşünce,inanmak
Region=Bölge
Register=Kayıt,sicil,kütük
Regular=Düzenli,olağan
Regulation=Yönetmelik,yasa
Reject=Kabul etmemek
Relation=İlişki,akrabalık
Relationship=İlişki,iletişim
Relative=Akraba,göreceli
Relax=Sakin,rahatlamak,gevşemek
Release=Serbest bırakmak,gevşetmek
Relevant=Bağıntılı,bağlantılı,konuyla ilişkili
Reliable=Güvenilir
Relief=Rahatlama
Relieve=Uzaklaştırmak
Religion=Din
Reluctant=İsteksiz,gönülsüz,ağırdan alan
Remain=Geriye kalmak,yerinde durmak
Remark=Belirtmek,açıklama,açıklamak
Remarkable=Dikkate değer
Remedy=Çare
Remember=Unutmamak,anımsamak
Remind=Anımsatmak
Remit=Affetmek,bağışlamak,havale
Remote=Uzak,uzaklaştırmak
Rent=Kiralamak
Repair=Onarmak,tamir etmek
Repay=Geri ödemek
Repeat=Tekrarlamak
Replace=Yeniden yerleştirmek,düzeltmek
Replacement=Yerleştirme
Reply=Yanıtlamak,yanıt
Report=rapor,rapor etmek,bildirmek
Represent=Temsil etmek
Representative=Temsilci
Republic=Cumhuriyet
Reputation=İtibar,ün
Request=Rica etmek,rica
Require=Gereksinmek
Rescue=Kurtarma,kurtarmak
Research=Araştırma
Resent=Hoşlanmamak,kızmak
Reserver=Rezerv,rezervasyon,rezervasyon yaptırmak
Resident=Bölgede yaşayan,oturan
Resign=İstifa etmek
Resist=Karşı koymak
Respect=Saygı duymak
Respectable=Saygıdeğer,saygı duyulan
Respond=Cevap vermek
Responsible=Sorumlu
Rest=Dinlenmek,geriye kalan
Restaurant=Restorant,lokanta
Restore=Geri verme,yeniden kullanıma açma,restore etmek
Restrict=Sınırlamak
Result=Sonuç
Resume=Devam etmek,yeniden başlamak
Retail=Parekende,parekende satış
Retaliation=İntikam,tepki,misilleme
Retire=Emekli olmak
Return=Geri dönmek
Revenge=Öç almak,intikam
Reverse=Ters,arka
Revise=Tekrar gözden geçirmek,tekrar gözden geçirip düzeltmek
Revolution=Devrim
Reward=Ödül
Rib=Kaburga
Rica=Pirinç
Rich=Zengin
Rid=Atmak,fırlatmak
Ride=Binmek
Ridiculous=Gülünç,saçma
Rifle=Tüfek
Right=Haklı,doğru,sağ taraf
Ring=Yüzük,halka
Ripe=Olgun,ham değil
Rise=Yükselmek
Risk=Risk
Risky=Riskli
River=Nehir
Road=Yol
Roar=Kükreme
Roast=Rosto,fırında pişirmek
Rob=Soygun yapmak
Rock=Kaya,sallanmak
Rokcet=roket
Role=Rol
Roll=Yuvarlanmak
Roof=Çatı
Room=Oda
Root=Kök
Rope=Halat,ip
Rose=Gül,pembe
Rough=Kaba
Round=Tur,yuvarlak,çember
Roundabout=Dolambaçlı,dolaylı,yaklaşık olarak
Route=Rota
Row=Sıra,gürültü
Row=Kürek çekmek
Royal=Kraliyete ait
Rub=Sürmek,sürtmek,ovmak
Rubber=Lastik,kauçuk,silgi
Rubbish=Çöp,saçma
Rude=Kaba
Rug=Küçük halı,kilim
Ruin=Harabe,yıkım,mahvetme
Rule=Yönetmek,kural
Ruler=Kural koyucu,yönetici,cetvel
Rumble=Gürlemek
Run=Koşmak,çalıştırmak
Runaway=Kaçak,kontrol dışı
Rush=Acele,hücum,koşuşturma
Rust=Pas,hamlama,körelme
