Label=Etiket
Laboratory=Labaratuvar
Labour=İş,işgücü
Lack=Eksiklik
Ladder=Merdiven
Ladle=Kepçe
Lady=Hanımefendi
Lake=Göl
Lamb=Kuzu,koyun eti
Lame=Topal
Lamp=Lamba
Lamppost=Sokak lambası
Lampshade=Abajur
Land=Kara,arazi,iniş yapmak
Landlady=Evsahibi bayan,evini kiraya veren
Lane=Dar yol,şerit
Language=Dil
Large=Geniş
Lash=Kamçı,birşeyi ani ve hızlı sallamak
Last=Son,sonunda,geçmiş
Late=Geç,sonu
Laugh=Gülmek
Launch=Birşeye başlamak,bir şeye başlamak,roket fırlatmak
Laundry=Yıkanacak çamaşır,çamaşırhane
Lavatory=Tuvalet
Law=Yasa,kanun
Lawful=Yasal
Lawyer=Avukat
Lay=Koymak,yatırmak
Lazy=Tembel
Lead=Kurşun,kurşun kalem ucu
Lead=Önderlik etmek,önde gitmek,yol göstermek
Leader=Önder,lider
Leadership=Önderlik
Leaf=Yaprak
League=Birlik,lig
Leak=Akıntı,sızmak
Lean=İnce,yağsız,yaslanmak
Learn=Öğrenmek
Lease=Kiralama,kira kontratı,kira bedeli
Least=En az
Leather=Terk etmek
Lecture=ders,konferans vermek
Left=Sol,kalan
Leg=Bacak
Legacy=Miras
Legal=Yasal
Lemon=Limon
Lend=Ödünç vermek
Length=Uzunluk
Lens=Lens
Less=Daha az
Lesson=Ders
Let=Bırakmak
Letter=Mektup,harf
Lettuce=Salata,kıvırcık
Level=Düzey,seviye
Lever=Kaldıraç,manivala
Liar=Yalancı
Liberal=Liberal
Liberty=Serbest olmak
Library=Kitaplık,kütüphane
License=Lisans
Lick=Yalamak
Lid=Kapak
Lie=Yalan,yalan söylemek,yatmak
Life=Yaşam,hayat
Lift=Asansör,yukarı kaldırmak
Light=Işık,hafif
Lighter=Çakmak
Like=Hoşlanmak,gibi
Likely=Büyük olasılıkla
Limit=Hat,sınır,limit
Line=Çizgi,satır,sıra
Link=Birleştirmek
Lip=Dudak
Liquid=Sıvı
Liquidate=Öldürme,kurtulmak,başından atmak
List=Liste
Listen=Dinlemek
Literature=Edebiyat
Litter=Çöp,dağınıklık
Little=Küçük
Live=Canlı,yaşamak
Liver=Karaciğer
Lives=Yaşamlar
Living=Yaşam biçimi
Load=Yük,yüklemek,silah doldurmak
Loaf=Bütün ekmek,vakti boşa geçirmek
Loan=Ödünç vermek,borç vermek,borç
Lobster=İstakoz
Local=Bölgesel,yerel
Locate=Kurmak,yerleştirmek
Lock=Kilitlemek,kilit
Lonely=Yalnız,kimsesiz
Long=Uzun
Look=Bakmak,bakış
Loose=Bol,bağsız
Lorry=Kamyon
Lose=Kaybetmek
Loss=Kayıp,zarar
Lot=Çok
Loud=Yüksek sesli
Love=Sevgi,aşk
Lovely=Sevimli
Low=Alçak,düşük,az
Lower=Aşağıya indirmek
Loyal=Sadık
Loyalty=Sadakat,bağlılık
Lucky=Şans
Lucky=Şanslı
Luggage=Valiz,yük
Lunch=Öğle yemeği
Lung=Akciğer
Luxury=Lüks
