Baby=Bebek
Babysitter=Çocuk bakıcısı
Bachelor=Bekar,fakülte mezunu,üniversite mezunu
Back=Arka,sırt,geri
Background=Fon,arkaplan,zemin
Bad=Kötü
Bag=Çanta
Baggage=Bagaj
Bake=Pişirmek
Baker=Fırıncı
Balance=Denge,bakiye
Balcony=Balkon
Bald=Kel
Ball=Top,balo
Ballerina=Balerin
Ballet=Bale
Balloon=Balon
Ban=Yasak
Banal=Banal,adi
Banana=Muz
Band=Bant,şerit,bando
Bandage=Bandaj,sargı,yara bandı
Banish=Sürgüne yollamak,düşünmekten vazgeçmek
Bank=Banka
Banker=Banka yöneticisi,bankacı
Banknote=Kağıt para
Bankrupt=İflas
Bar=Çubuk,bar
Barbarous=Barbar,vahşi
Barber=Berber
Bare=Çıplak,boş
Bargain=Pazarlık etmek,kelepir
Barrel=Varil,namlu
Base=Taban,üs
Basement=Bodrum
Basket=Sepet
Bath=Yıkanmak
Bathe=Yıkamak
Battery=Pil
Battle=Savaş,muhabere
Bay=Koy,peron
Beach=Sahil
Bean=Fasulye
Bear=Ayı,taşımak,dayanabilmek
Beard=Sakal
Beast=Canavar
Beat=Vurmak,yenmek
Beautiful=Güzel
Beauty=Güzellik
Because=Çünkü
Become=Gelişmek,değişmek
Bed=Yatak
Bee=Arı
Beef=Dana eti
Beer=Bira
Beetle=Hamamböceği
Before=Önce
Beforehand=Önceden
Beg=Dilenmek
Begin=Başlamak
Behave=Davranmak
Behind=Arkada,geride
Being=Varlık
Believe=İnanmak,inanç
Bell=Zil,çan
Belong=Ait olmak
Below=Altta,aşağıda
Belt=Kemer
Bench=Tezgah,bank
Bend=Eğmek,eğilmek
Beneath=Altında
Benefit=Yararı olmak,fayda,avantaj
Berry=Dut,meyve,istakoz yumurtası
Beside=Yanında
Besides=Hem de
Best=En iyisi
Bet=İddia etmek,iddiaya girmek
Better=Daha iyi
Between=Arasında
Beyond=Ötesinde
Bicycle=Bisiklet
Big=Büyük
Bike=Bisiklet
Bill=Fatura,hesap,gaga
Bin=Kap
Bind=Bağlamak
Bird=Kuş
Birth=Doğum
Birthday=Doğumgünü
Biscuit=Bisküvi
Bishop=Piskopos,fil
Bit=Parça,matkap,uç
Bite=Isırmak
Black=Siyah
Blade=Ustura,bıçak
Blame=Sorumlu tutmak,suçlamak
Blank=Boşluk
Blanket=Battaniye
Blast=Patlayarak parçalanma,mahvetmek
Bless=Kutsamak,şükretmek,takdis etmek
Blind=Kör
Block=Blok
Blood=Kan
Bloom=Çiçek,çiçek açmak
Blouse=Bluz
Blow=Üflemek,patlamak
Blue=Mavi,mutsuz
Bluff=Blöf
Board=Binmek,tahta,kurul
Boast=Övünmek
Boat=Bot,sandal
Body=Gövde,vücut
Bodyguard=Koruma görevlisi,goril
Boil=Kaynamak
Boiler=Kazan
Bold=Cüretkar,utanmaz,korkusuz
Bolt=Civata,sürgü,somun
Bomb=Bomba
Bone=Kemik
Bonfire=Meydan ateşi,şenlik ateşi
Bonnet=Çocuk başlığı,arabanın kaputu
Book=Kitap
Book=Yer ayırtmak
Booklet=Broşür
Boom=Patlamak,çok hızlı genişlemek
Boot=Ayakkabı,bot,bagaj
Border=Sınır
Bore=Can sıkmak
Bored=Canı sıkılmış,sıkılmak
Boring=Sıkıcı
Born=Doğmuş
Borrow=Ödünç almak
Boss=Patron
Both=İkisi
Bother=Can sıkmak,üzmek
Bottle=Şişe
Bottom=En alt,dip
Bounce=Yansıtmak,zıplamak
Bound=Bağlı,sınırlı,atlamak
Boundary=Sınır
Bow=Yay
Bowl=Tas,kase,çanak
Box=Kutu,boks
Boy=Erkek çocuk,erkek
Brain=Beyin
Brake=Fren,frenlemek
Branch=Dal,şube,kol
Brand=Marka,lekelemek,kötü ün
Brand-new=Yeni model,yepyeni
Brave=Korkusuz,cesur
Bread=Ekmek
Break=Kırmak
Break down=Çöküş,ayırma,detaylandırma
Breakfast=Kahvaltı
Break-out=Aniden başlama,patlak vermek,kaçmak
Breast=Göğüş
Breath=Nefes
Breathe=Nefes almak
Bribe=Rüşvet
Bride=Gelin
Bridge=Köprü
Brief=Kısa,özetli
Briefcase=İş çantası
Bright=Parlak
Brilliant=Parlak,akıllı
Bring=Getirmek
Broad=Geniş
Broadcast=Yayın
Broken=Kırık
Broker=Komisyoncu,simsar
Brother=Erkek kardeş,ağabey
Brother-ın-law=Kayınbirader
Brown=Kahverengi
Brush=Fırça,fırçalamak
Bucket=Kova
Budget=Bütçe,bütçe yapmak
Build=İnşa etmek,yapmak
Building=Bina
Bulb=Ampul
Bull=Boğa
Bullet=Mermi
Bump=Çarpışma
Bumper=Tampon
Bumpy=Engebeli
Bunch=Deste,demet
Bungalow=Bungalov
Burglar=Hırsız
Burn=Yanmak
Burst=Patlamak
Bury=Gömmek
Bus=Otobüs
Bush=Çalı
Business=İş
Busy=Meşgul,yoğun,işlek
But=Ama,fakat
Butcher=Kasap
Butter=Tereyağ
Button=Düğme
Buy=Satın almak
By=Yanında,sırasında,etrafında
