İce=Buz
İce-cream/ice cream=Dondurma
İcy=Çok soğuk,buzlu
İdea=Fikir
İdeal=Yetkin,ideal
İdentical=Özdeş,çok benzeyen,aynı
İdentify=Belirlemek,tanımlamak,belirtmek
İdiot=Aptal
İdle=Atıl,boş
İf=Eğer
İgnition=Tutuşma,ateşleme,ateş alma
İgnore=Önemsememek
İll=Hasta,hastalık
İllegal=Kanunsuz
İllustrate=Resimle göstermek
İmage=Hayal,imaj,resim
İmagination=Tasavvur,hayal
İmagine=Tasavvur etmek,hayal etmek
İmitate=Örnek almak,taklit etmek
İmitation=Taklit
İmmediate=Anında,derhal
İmmense=Çok büyük
İmmigrate=Göçmen
İmmoral=Ahlaksız,edepsiz
İmpair=Bozmak
İmpatient=Sabırsız
İmplement=Yürürlüğe koymak,alet
İmply=İma etme
İmpolite=Kaba,nazik değil
İmport=İthal etmek
İmportance=Önem
İmportant=Önemli
İmpossible=Olanaksız
İmpress=Etkilemek
İmpression=Etki
İmpressive=Etkili,etkileyici
İmprove=Gelişmek,iyiye gitmek
İmprovement=Gelişme
İn=İçinde,içeri,içeriye
İn order to=Amacıyla,maksadıyla
İncentive=Teşvik
İncident=Olay,önemsiz olay
İncidentally=Bunun yanında
İnclude=Kapsamak
İncome=Gelir
İncorrect=Hatalı,yanlış
İncrease=Artmak
İncredible=İnanılmaz,büyüleyici
İndeed=Gerçekten
İndefinite=Belirsiz
İndefinitely=Sonsuz,süresiz
İndemnify=Tazminat ödemek,söz vermek,zararı karşılamak
İndemnity=Tazminat
İndependent=Bağımsız
İndex=İndex
İndicate=Göstermek,işaret etmek
İndividual=Ayrı,birey,fert
İndoor=Evi çinde,içerde,içeride
İndorse=Çeki ciro etmek,onaylamak
İndustry=Endüstri
İnevitable=Kaçınılmaz,herhalde olan
İnferior=Aşağılık
İnfinite=Sonsuz
İnflammable=Ateş alabilir
İnflate=Şişmek
İnflation=Enflasyon
İnflexible=Eğilmesi zor,bükülmez,inatçı
İnfluence=Etki,etkilemek
İnform=Bilgi vermek
İnformal=Resmi olmayan,gayri resmi
İnformation=Bilgi,enformasyon
İnitial=İlk harf,birinci,baştaki
İnitiative=İlk hareket,başlatma,insiyatif
İnject=Şırınga yapmak,enject etmek,iğne yapmak
İnjure=İncitmek
İnk=Mürekkep
İnn=Han,motel
İnnocent=Suçsuz,masum
İnquire=Araştırmak
İnquiry=Soru
İnsect=Böcek
İnsecure=Emniyetsiz
İnside=İçerisi
İnsist=Israr etmek
İnsolvent=Müflis
İnspect=İncelemek
İnspector=Müfettiş
İnspire=Esinleme,ilham gelmesi,fikre getirme
İnstall=Yüklemek,yerleştürmek
İnstance=Örnek
İnstant=Hızlı,derhal
İnstead of=Yerine
İnstitute=Enstitü,kuruluş
İnstruction=Yönerge,talimat
İnstrument=Enstrüman
İnsulate=İzole etmek
İnsult=Hakaret etme,onur kırma
İntangible=Manevi,maddi olmayan
İntelligent=Zeki
İntend=Planlamak,maksat,niyet
İntense=Derin üzüntü,güçlü duygu
İntensive=Yoğun
İntention=Plan
İnterest=ilgi duymak,enterese olmak,faiz
İnteresting=İlginç
İnterfere=Karışma,müdahele etme,parazit yapma
İntermediate=Arada
İnternational=Uluslararası
İnterpret=Çeviri,yorumlamak
İnterrupt=Durdurmak,kesmek,araya girmek
İnterval=Aralık,ara
İnterview=Röportaj,görüşme
İntestines=Bağırsaklar
İnto=İçine
İntroduce=Tanıştırmak
İnvade=İstila etmek
İnvalid=Geçersiz
İnvent=İcat etmek,yaratmak,oluşturmak
İnvest=Yatırım yapmak
İnvestigate=Araştırma yapmak,çalışmak
İnvite=Davet etmek
invoice=Fatura
İnvolve=İşe dalmak,karışmak,içermek
İron=Demir,ütü
İronically=Tam aksi olma,inadına
İrregular=Düzensiz
İrritate=Kızdırmak,sinirlendirmek,tahriş etmek
İsland=Ada
İssue=Baskı,konu,vermek
İt=Cansız,üçüncü tekil sahış zamiri
İtch=Kaşındırmak
İtem=Birim,eşya,madde
