Dad=Baba
Daily=Günlük
Daisy=Papatya
Dam=Baraj
Damage=Zarar,hasar,zarar vermek
Damp=Nemli
Dance=Dans
Danger=Tehlike
Dangerous=Tehlikeli
Dare=Cesaretli olmak,cüret göstermek,meydan okumak
Dark=Karnalık,koyu,siyah tenli
Darling=Sevgili
Dash=Fırlamak,aniden koşmak
Date=Günün tarihi,tarih
Daughter=Kız çocuk
Day=Gün
Dead=Ölü
Deadline=Son teslimat tarihi,mühlet
Deadlock=Çıkmaz,açmaz
Deaf=Sağır
Deal=Alıp satmak,iş yapmak
Dear=Sevgili,sevilen,pahalı
Death=Ölüm
Debetable=Tartışabilinir
Debate=Tartışma
Debt=Borç
Decay=Çürümek,bozulmak
Deceive=Kandırmak
December=Aralık,aralık ayı
Decent=Doğru,haklı,iyi
Decide=Karar vermek
Decision=Karar
Declare=Açıklamak
Decline=Azaltmak,gerilemek,düşmek
Decorate=Dekore etmek,döşemek
Decrease=Azaltmak,azalma
Deed=Eylem,tapu
Deep=Derin
Deer=Geyik
Default=Varsayılan,ifa etmeme,hazı bulunmama
Defeat=Kaybetmek
Defence=Defans,savunma
Defend=Savunmak
Defer=Geciktirme,erteleme
Deficit=Açık
Definite=Kesin,belirli
Definition=Tanımlama
Degree=Derece
Delay=Gecikme,ertelemek
Deliberately=Kasten
Delicate=Nazik
Delicious=Lezzetli
Delight=Hoşnutluk
Delightful=Hoşnut edici
Deliver=Dağıtmak,dağıtım
Demand=İstek,talep,ihtiyaç
Demolish=Yıkmak,parçalamak
Demonstrate=Açıkça göstermek,demonstre etmek
Demonstration=Gösteri
Demoralize=Cesaretini kırmak,moral bozmak
Dentist=Dişçi
Deny=İnkat etmek,yalanlamak
Depoart=Ayrılmak
Depoartment=Bölüm,departman
Depend=Bağımlı olmak,ihtiyacı olmak
Dependent=Bağımlı
Deposit=Depozit
Depress=Bunaltmak
Depth=Derinlik
Deputation=Vekillik
Deputy=Vekil
Describe=Tanımlamak,betimlemek
Deser=Çöl,haksız yere terk etmek
Deserve=Hakketmek,layık olmak
Design=Dizayn
Desire=Arzu
Desk=Sıra,masa
Despair=Ümitsizlik
Desperate=Umutsuz,çok ciddi
Despite=Rağmen
Dessert=Tatlı
Destination=Varış noktası
Destroy=Yıkmak
Destruction=Yıkım
Detach=Ayırmak
Detail=Ayrıntı,detay
Detective=Dedektif
Determined=Azimli
Develop=Gelişmek,büyükmek,resim basmak
Development=Gelişme
Devil=Şeytan
Dew=Kırağı,nem
Diagram=Şema,diyagram
Dial=Gösterge,telefon etmek
Diameter=Çap
Diamond=Elmas,karo
Diary=Günlük,ajanda
Dice=Zarlar,tavla zarları
Dictator=Diktatör
Dictionary=Sözlük
Die=Ölmek
Diet=Rejim,diyet
Difference=Ayırım,fark
Different=Farklı
Difficult=Zor
Dig=Kazmak
Digest=Hazm etmek,olayı kavramak,kura
Dim=Kısık,sönük
Dinner=Akşam yemeği
Dip=Daldırmak
Diploma=Diploma
Diplomat=Diplomat
Direct=Direk,yönlendirmek,yol vermek
Direction=Yön
Director=Direktör
Directory=Rehber
Dirt=Kir
Dirty=Kirli
Disadvantage=Dezavantaj
Disagree=Anlaşamamak,uyuşmamak
Disappear=Gözden kaybolmak
Disappoint=Hayal kırıklığı,hayal kırıklığına uğramak
Disaster=Felaket,afet
Disc=Disk
Discipline=Disiplin
Disclose=Açığa çıkmak,meydana çıkmak,bilinmesini sağlamak
Disco=Disko
Discover=Keşfetmek
Disease=Hastalık
Disgust=Tiksinti
Dish=Tabak,bulaşık,özel yemek
Dismay=Süpriz,üzüntü
Dismay=Korku,dehşet
Dismiss=Kovmak,yol vermek,salmak
Disobey=İtaat etmemek
Dispatch=Sevk etmek,yollamak
Displace=Yerinden çıkarmak,yerinden çıkartmak
Display=Göstermek
Dispose=Atmak,bırakmak,ortaya çıkarmak
Dispute=Anlaşmazlık
Distance=Uzaklık
Distant=Uzak
Distinct=Açık,özel,farklı
Distinction=Küçük farklılık,farklılık
Distinguish=Ayırt etme
Distribute=Dağıtmak
District=Bölge,toprak,ülke
Disturb=Rahatsız etmek
Dive=Dalış
Diver=Dalgıç
Divide=Bölmek,paylaştırmak
Division=Bölüm
Divorce=Boşanmak
Dizzy=Baş dönmesi
Do=Yapmak
Dock=Tersane,sanık iskemlesi,dok
Doctor=Doktor
Document=Doküman
Dog=Köpek
Doll=Oyuncak bebek
Domestic=Evcil,eve ait,içsel
Dominate=Hakim olma
Donate=Bağış yapmak
Donation=Bağış
Donkey=Eşek
Donor=Bağış yapan,iyilik sever
Doom=Kötü kader,kör talih
Doomsday=Ahiret günü
Door=Kapı
Dose=Doz,bir parça,bir seferde alınan ilaç miktarı
Double=Çift
Doubt=Şüphe,emin olmamak
Down=Aşağı,aşağısı
Down payment=Peşin,peşin ödeme
Doze=Uyuklamak,hafif uyku
Dozen=Düzine
Draft=Suret,müsvedde,banka çeki
Drag=Sürüklemek
Dragon=Ejderha
Drain=Lağım,su yolu
Drama=Dram
Draught=Hava akımı,ceryan
Draughts=Dama oyunu
Draw=Çizmek,çekmek
Drawer=Çekmece,göz
Drawn=Boğulmak
Dreadful=korkunç,kötü
Dreadfully=Çok
Dream=Düş,hayal,rüya
Dress=Giysi,giyinmek
Drill=Delmek,öğretmek,tekrar tekrar öğretmek
Drink=İçmek
Driver=Araba kullanmak,sürmek
Drop=Düşürmek,düşmek,damla
Drug=İlaç,uyuşturucu
Drug=Uyuşturucu madde,ilaç
Drum=Davul,makara,varil
Drunk=Sarhoş
Dry=Kuru,kurumak
Duck=Örnek,başını eğmek
Duckling=Küçük örnek
Due=Kadar,vade,borç
Duel=Düello
Dull=Aptal,kapalı,sıkıcı
Dust=Toz
Dustbin=Çöp tenekesi
Duty=Görev,gümrük vergisi
Dye=Boya,boyamak
Dynamite=Dinamit
Dynamo=Dinamo
Dynasty=Hanedanlık
