Sabotage=Sabotaj
Sack=Çuval,kovmak,istifaya zorlamak
Sacrifice=Kurban,fedakarlık
Sad=Üzgün,mutsuz
Saddle=Eğer
Safari=Safari,hayvan avlama yolculuğu
Safe=Güvenli,emin,kasa
Safety-belt=Emniyet kemeri
Safety-pin=Çengelli iğne
Sail=Deniz yolculuğu
Sailor=Denizci
Sake=Hatır,uğruna
Salad=Salata
Salary=Maaş
Sale=Satış
Salmon=Som balığı,sarımsı,pembe
Saloon=Salon
Salt=Tuz
Salute=Selam vermek
Same=Aynı,farksız
Sample=Örnek,numune
Sand=Kum
Sandal=Sandalet
Sandpapter=Zımpara kağıdı,zımparalamak,zımpara
Sandwich=Sandviç
Satellite=Uydu
Satin=Saten,atlas
Satisfy=Tatmin etmek
Saturday=Cumartesi
Saucepan=Tava
Sausage=Sosis
Savage=Vahşi,yabani,yırtıcı
Save=Korumak,tasarruf etmek
Savaour=Tat,lzzet,çeşni
Saw=Testere,görmek
Saxophone=Saksafon
Say=Demek,söylemek
Scale=Ölçek,tart
Scandal=Skandal
Scarce=Kıt,nadir,sınırlı
Scare=Korkutmak
Scarf=Atkı
Scene=Olayın geçtiği yer,manzara,tiyatronun bir sahnesi
Scheme=Plan,proje
Scholarship=Burs
School=Okul
Science=Bilim
Scissors=Makas
Scone=Çörek,saç pidesi
Score=Skor
Scorpion=Akrep
Scramble=Çırpmak,hızlı hareket,hızlı tırmanış
Scrape=Kazımak,sürtmek,pislik
Scratch=Tırmalamak,kaşımak
Scream=Çığlık
Screen=Ekran,perde,perdelemek
Screw=Vidalamak,vida,kazıklamak
Scruff=Ense,kirli,pasaklı insan
Sea=Deniz
Seal=Mühürlemek
Search=Araştırmak
Seashore=Deniz kıyısı
Seaside=Deniz kenarı
Season=Sezon,mevsim
Seat=Oturulacak yer
Seat-belt=Emniyet kemeri
Second=Saniye,ikinci
Second-rate=İkinci derece,kalite
Scret=Gizli,sır
Secretary=Sekreter
Section=Kısım,bölüm
Secure=Emniyetli,sağlam
See=Görmek,fark etmek,anlamak
See over=İmtihan etmek,çek etmek
Seed=Tohum,çekirdek
Seek=Aramak,soruşturmak
Seem=Görünmek
Segment=Dilim,dilimlemek,bölmek
Seize=Ele geçirmek,kaçırmamak,yakalamak
Seldom=Arka sıra,sık değil
Select=Seçmek
Selection=Seçim
Selfish=Bencil
Sell=Satmak
Semi=Yarı
Senate=Senato
Send=Göndermek,yollamak
Senior=Yaşça büyük,kıdemce büyük,rütbeli
Sense=Duyu
Senseless=Aptalca,bilinçsiz
Sensible=Akıllı
Sensitive=Duyarlı,alıngan
Sentence=Cümle,hüküm giyme,mahkum olma
Separate=Ayrı,ayırmak
September=Eylül
Sergeant=Çavuş
Serial=Seri
Serious=Ciddi
Sermon=Vaaz
Servant=Hizmetçi
Serve=Hizmet etmek,servis yapmak
Service=Servis
Serviette=Peçete
Set=Ayarlamak,yerleştirmek,hazırlamak
Set on=Atak,saldırı
Settle=Durup dinlenmek,alışmak,yerleşmek
Settlement=Anlaşma
Several=Bir kaç
Severe=Sert,ciddi
Sew=Dikiş,dikmek
Sex=Cinsiyet,seks,cinsel
Shade=Gölge,gölgelemek
Shadow=Karnalık,gölge,gizlice izlemek
Shake=Sarsmak
Shallow=Sığ
Shame=Utanç
Shampoo=Şampuan,baş yıkamak
Shape=Şekil,form
Share=Paylaştırmak,paylaşmak,pay
Shark=Köpek balığı
Sharp=Keskin,tam tamına,zeki
Sharp shooter=Keskin nişancı
Shave=Traş,tıraş
Sheep=Koyun,koyunlar
Sheet=Çarşaf,ince tabaka
Shelf=Raf
Shell=Kabuk,bombalamak
Shelter=Sığınmak
Shield=Kalkan,kılıf
Shift=Değiştirme,vardiye
Shine=Parlamak,parlatmak
Ship=Gemi,gemiyle yollamak
Shirt=Gömlek
Shock=Şok,şok etmek
Shoe=Ayakkabı
Shoelace=Ayakkabı bağı
Shoot=Ateş etme,şut atma,tomurcuk
Shoot down=İmha etmek,hayır cevabı,olumsuz
Shop=Dükkan,alışveriş yapmak
Shopping=Alışveriş
Shore=Kıyı
Short=Kısa,aniden
Short cut=Kestirme
Shortage=Yokluk,kıtlık
Shortly=Kısa bir zaman sonra,kısaca
Shot=Atış
Shoulder=Omuz
Shout=Bağırmak
Show=Göstermek,gösteri
Shower=Duş,duş almak,sağanak yağmur
Shrink=Çekmek,küçülmek
Shut=Kapatmak
Shy=Utangaç
Sick=Hasta
Side=Kenar,yan,taraf
Sigh=Derin nefes almak
Sight=Görüş
Sign=İşaret,imzalamak,iz
Signal=Sinyal,sinyal vermek
Significant=Manalı,önemli
Signpost=İşaret direği
Silence=Sessizlik,susturmak
Silent=Sessiz,sakin,susmuş
Silk=İpek
Silly=Budala,aptal
Silo=Depo
Simplify=Basitleştirmek
Sin=Günah
Since=Şimdiye kadar,den beri,çünkü
Sincere=İçten,samimi,sahte olmayan
Sing=Şarkı,şarkı söylemek
Singular=Acayip,tek,eşsiz
Sink=Batmak,evye
Sir=Efendi
Siren=Siren
Siter=Kız kardeş,hemşire,rahibe
Sit=Oturmak
Situation=Durum
Size=Büyüklük,boyut
Skate=Buz pateni,paten ayakkabısı
Skateboard=Kaykay,kay kay
Skeleton=İskelet
Ski=Kayak,kayak yapmak
Skill=Yetenek
Skim=Köpük,yağını almak,ana fikri almak
Skin=Deri
Skirt=Etek
Skull=Kafatası
Sky=Gökyüzü
Slang=Argo
Slave=Köle
Sleep=Uyumak,uyku
Sleepy=Uykulu,sakin
Slice=Dilim,dilimlemek
Slide=Kaydırak,kaydırmak
Slide=Slayt,sürgü,kızak
Slight=Önemsiz,küçük
Slim=İnce,zayıf,zayıflamaya çalışmak
Slip=Yuvarlanmak,kaymak,düşmek
Slipper=Terlik
Slope=Eğim
Slot=Uzun,boşluk,düz delik
Slow=Yavaş,yavaşlamak
Small=Küçük,ufak
Smart=Akıllı,açıkgöz,şık
Smash=Parçalamak,ezmek,vurmak
Smell=Koku,koklamak
Smile=Gülümsemek
Smoke=Duman,sigara,tüttürmek
Smooth=Düzgün,yumuşak
Smuggle=Kaçakçılık
Snack=Küçük,hızlı yenilen yemek
Snag=Pürüz
Snail=Sümüklüböcek
Snake=Yılan
Sneeze=Hapşırmak
Sniff=Burnunu çekmek
Snore=Horlamak
Snow=Kar
Snub=Küçümsemek,hakir görmek
So=Öyleyse,bu yüzden,bu şekilde
Soak=Islatmak
Soap=Sabun
Soccer=Futbol
Social=Sosyal
Society=Sosyete,çevre,toplum
Sock=Çorap,vurmak,kırmak
Socket=soket,priz
Sofa=Divan,sofa
Soft=Yumuşak
Soil=Toprak
Soldier=Asker
Solemn=Ciddi,bayıltıcı
Solid=Katı,sert
Solidarity=Dayanışma
Solve=Çözüm bulmak,çözmek
Some=Bazı,birkaç,yaklaşık
Somebody=Birisi
Someone=Biri
Sometimes=Bazen
Somewhere=Bir yer
Son=Erkek çocuk,oğul
Song=Şarkı
Soon=Yakında
Sophisticated=İncelikli sosyal hayattan bilgisi olan,ukala,karışık
Sore=Ağrı verici
Sorrow=Üzüntü
Sorry=Üzgün
Sort=Çeşit,sıralamak
Soul=Ruh
Sound=Ses,mantıklı,toplam
Soup=Çorba
Sour=Ekşi
Source=Kaynak
South=Güney
Souvenir=Hatıra
Sow=Toprağa ekmek
Space=Uzay,boşluk,yer
Spade=Maça,kürek
Span=Karış,süre,mesafe
Spanner=Somun sıkma aleti,ingiliz anahtar
Spare=Ekstra,fazla,yedek
Speak=Konuşmak
Special=Özel,en iyi
Spectacular=Görülmeye değer
Spectator=İzleyici
Speech=Konuşma
Speed=Hız,hızlı gitmek
Speedometer=Hızöçler,hız ölçer
Speel=Büyülü,büyülü sözcükler,büyülü kelime
Spend=Para harcamak,harcamak
Spice=Baharat
Spider=Örümcek
Spill=Dökmek,saçmak
Spiral=Spiral
Spirit=Ruh,ruhsal durum,alkollü içki
Spit=Tükürmek
Spite=Rağmen,birisine zarar verme isteği
Splash=Sıçratma
Splendid=Nefis,harika
Split=İkiye bölmek
Spoil=Zarar vermek,şımartmak
Spoon=Kaşık
Sport=Spor
Spot=Lekelemek,tanımak,ayırmak
Spread=Yayılmak,yaymak
Spring=İlkbahar,yay,pınar
Spy=Casus
Square=Kare
Squash=Bir çeşit oyun,sıkışmak
Squeeze=Sıkışmak,sıkıştırmak,sıkmak
Stabilize=Dengeleme,saptama
Stable=Ahıt,istikrarlı
Stadium=Stadyum
Staff=Eleman,memur
Stage=Evre,safra,sahne
Stain=Lekelemek
Stair=Merdiven
Stall=Küçük dükkan,tezgah,vakit kazanma
Stamp=Pul,damga,ezmek
Stand=Ayakta durmak,durmak,direnmek
Standard=Standart,normal,klasik
Stapler=Zımba
Star=Yıldız
Stare=Uzun süre bakmak
Start=Başlamak,başlangıç
State=Devlet,durum
Station=İstanyon,durak
Statue=Heykel
Stay=Kalmak
Steady=Sabit
Steak=Bonfile
Steal=Çalmak
Steam=Buhar
Steel=Çelik,büyük güç
Steep=Hızlı yükselme,düşme,geniş açı
Steer=Didon,yönlendirmek
Step=Adım,adım atmak,üvey
Step child=Üvet çocuk
Sterile=Ameliyatla kısır etmek,bakteri
Sterilize=Kısırlaştırma,miktoplardan arıtma,arındırma
Stethoscope=Göğüş dinleme cihazı,steteskop
Steward=Erkek hostes,kahya
Stick=Sopa,baston,yapıştırmak
Stiff=Kolay bükülmeyen,sert
Still=Hareketsiz,sakin,hala
Stir=Karıştırmak,hareket ettirmek
Stock=Stok,stok yapmak,hisse senedi
Stocking=Kadın çorabı
Stomach=Mide
Stone=Taş,meyve çekirdeği
Stool=Tabure
Stop=Durmak,nokta,durak
Store=Dükkan,depolamak
Storm=Fırtına
Story=Öykü,hikaye
Stove=Soba
Straight=Düzgün,en kısa yoldan
Strain=Germek,çok güç,zor
Strainer=Süzgeç
Strange=Garip,tuhaf
Strap=Tutacak,askı
Straw=Saman,kamış,hasır
Strawberry=Çilek
Stream=Irmak
Street=Cadde
Strength=Güç,kuvvet
Stress=Bastırmak,stres
Stretch=Gerinmek,germek,bir kerede
Stretcher=Sedye
Strict=Katı
Strike=Grev yapmak,grev,vurmak
String=İp,tel,dizi
Strip=Soymak,soyunmak
Stripe=Şerit çizgisi,kırbaç cezası
Stroke=Çarpış,felç,okşamak
Strong=Güçlü
Structure=Yapı
Struggle=Kavga etmek,çaba
Student=Öğrenci
Studio=Stüdyo
Study=Çalışmak,okumak,incelemek
Stuff=Cisim,şey,tıkıştırmak
Stupid=Aptal
Stutter=Kekelemek,kekeme
Style=Stil
Subject=Konu,özne
Submarine=Denizaltı
Submit=Göndermek,sunmak,boyun eğmek
Subscribe=Abone olmak,abone parası ödeme,sürekli para yardımı yapmak
Subsidize=Yardım etme
Subsidy=Yardım,sübvansiyon
Substance=Madde,cevher
Substitute=Vekil tayin etme,yatin etme,yerine geçme
Subtract=Çıkartmak,çıkarma
Subway=Alt geçit,alt yol
Succeed=Başarılı olmak,varis,başarmak
Success=Başarı
Succession=Ardarda,devamlı
Such=Bunun gibi,bu kadar
Suck=Emmek
Sudden=Ani
Suffer=Acı çekmek
Sufficient=Yeterince
Sugar=Şeker
Suggest=Önermek
Suggestion=Öneri
Suicide=İntihar
Suit=Yakışmak,uygun gelmek,takım elbise
Suitcase=Bavul
Sum=Toplam
Summary=Özet
Summer=Yaz
Summit=Zirve
Sun=Güneş
Sunday=Pazar günü
Sunset=Güneşin batışı
Sunshine=Güneş ışığı
Suntan=Bronz rengi
Super=Süper
Sperb=Harika,çok güzel
Superior=Daha iyi,önemli,akıllı
Superstition=Batıl inanç
Supervise=Denetleme,gözlem
Supper=Yemek,günün son yemeği
Supplies=Erzak,mal
Supply=Sağlamak,miktar
Support=Taşımak,yardım etmek,destek
Suppose=Sanmak
Suppress=Baskı altına alma,sindirme,yayınlanmasını önleme
Supreme=Yüce,üstün
Sure=Emin,kesin
Surface=Yüzey
Surgeon=Cerrah
Surgery=Ameliyat
Surname=Soyadı
Surprise=Şaşırtmak,sürpriz
Surrender=Teslim olmak
Surround=Çevrelemek
Suspect=Şüphelenmek
Suspend=Askıya almak,durdurmak
Suspension=Asma,asılma
Suspicion=Şüphe
Swallow=Yutmak,kırlangıç
Swan=Kuğu
Swear=Yemin etmek,küfretmek
Sweat=Ter,terlemek
Sweater=Süveter
Sweep=Süpürmek
Sweet=Tatlı
Swell=Şişmek,kalınlaşmak
Swim=Yüzmek
Swing=Sallanmak,güçlü ritim
Switch=Açmak,kapatmak
Swollen=Şişmiş
Sword=Kılıç
Symbol=Sembol
Syrup=Şurup
System=Sistem
